...........
.#.#.#.#.#.
...........
.#.......#.
...........
.#.......#.
...........
.#.......#.
...........
.#.#.#.#.#.
...........
