###########
#.........#
#.@@...@@.#
#.@.....@.#
#...@@@...#
#.........#
#...@@@...#
#.@.....@.#
#.@@._.@@.#
#.........#
###########
