###########
#...*.....#
#.@@...@@.#
#*@.....@.#
#...@@@...#
#.*.......#
#...@@@..*#
#.@.....@.#
#.@@._.@@.#
#......*..#
###########
