###########
#....*....#
#.@@@@@@@.#
#.@....*@.#
#.@.@@@.@.#
#...@#@._.#
#.@.@@@.@.#
#.@....*@.#
#.@@@@@@@.#
#*.......*#
###########
