...........
.#...#...#.
...........
...#...#...
...........
...........
...........
...#...#...
...........
.#...#...#.
...........
