###########
#.........#
#.@@@@@@@.#
#.@.....@.#
#.@.@@@.@.#
#...@.@...#
#.@.@@@.@.#
#.@.....@.#
#.@@@@@@@.#
#.........#
###########
