###########
#......@..#
#.@.......#
#.........#
#...@@@...#
#...@@@...#
#....@....#
#.........#
#._....@..#
#.........#
###########
